date,total,subscriber,customer,totalAvg,subscriberAvg,customerAvg,temp,rain,weekend,weekday,BART,49ers,Giants,Sharks,AmericasCup,USGovShutdown,holiday,holidayName
08/29/13,23,15,8,248,151,97,71,,0,5,0,,,,,,0,
08/30/13,11,3,8,251,157,94,74,,0,6,0,,,,,,0,
08/31/13,30,6,24,269,66,203,69,,1,7,0,,,,,,0,
09/01/13,11,0,11,233,51,182,71,,1,1,0,,,,,,0,
09/02/13,4,0,4,216,158,58,71,,0,2,0,,,,,,1,Labor Day
09/03/13,19,6,13,260,175,85,70,,0,3,0,,,,,,0,
09/04/13,7,1,6,229,147,82,70,,0,4,0,,,,,,0,
09/05/13,4,1,3,248,151,97,70,,0,5,0,,1,,,,0,
09/06/13,7,5,2,251,157,94,73,,0,6,0,,1,,,,0,
09/07/13,26,1,25,269,66,203,78,,1,7,0,,1,,1,,0,
09/08/13,13,3,10,233,51,182,73,,1,1,0,1,1,,1,,0,
09/09/13,9,2,7,216,158,58,73,,0,2,0,,1,,,,0,
09/10/13,11,4,7,260,175,85,70,,0,3,0,,1,,1,,0,
09/11/13,8,3,5,229,147,82,67,,0,4,0,,1,,,,0,
09/12/13,9,5,4,248,151,97,67,,0,5,0,,,,1,,0,
09/13/13,12,8,4,251,157,94,66,,0,6,0,,,,,,0,
09/14/13,16,2,14,269,66,203,65,,1,7,0,,,,1,,0,
09/15/13,15,2,13,233,51,182,68,,1,1,0,,,,1,,0,
09/16/13,9,1,8,216,158,58,71,,0,2,0,,,,,,0,
09/17/13,16,6,10,260,175,85,67,,0,3,0,,,,1,,0,
09/18/13,12,8,4,229,147,82,69,,0,4,0,,,,1,,0,
09/19/13,6,2,4,248,151,97,69,,0,5,0,,,,1,,0,
09/20/13,12,6,6,251,157,94,66,,0,6,0,,,,1,,0,
09/21/13,5,2,3,269,66,203,64,1,1,7,0,,,,1,,0,
09/22/13,21,1,20,233,51,182,63,,1,1,0,1,,,1,,0,
09/23/13,13,8,5,216,158,58,68,,0,2,0,,,,1,,0,
09/24/13,7,4,3,260,175,85,68,,0,3,0,,1,,1,,0,
09/25/13,12,6,6,229,147,82,63,,0,4,0,,1,,1,,0,
09/26/13,8,7,1,248,151,97,65,,0,5,0,,1,,,,0,
09/27/13,13,7,6,251,157,94,65,,0,6,0,,1,,,,0,
09/28/13,7,2,5,269,66,203,67,,1,7,0,,1,,,,0,
09/29/13,6,5,1,233,51,182,66,,1,1,0,,1,,,,0,
09/30/13,4,3,1,216,158,58,67,,0,2,0,,,,,,0,
10/01/13,8,5,3,260,175,85,63,,0,3,0,,,,,1,0,
10/02/13,18,14,4,229,147,82,64,,0,4,0,,,,,1,0,
10/03/13,17,5,12,248,151,97,63,,0,5,0,,,1,,1,0,
10/04/13,11,9,2,251,157,94,70,,0,6,0,,,,,1,0,
10/05/13,17,1,16,269,66,203,68,,1,7,0,,,1,,1,0,
10/06/13,20,1,19,233,51,182,67,,1,1,0,1,,,,1,0,
10/07/13,11,8,3,216,158,58,67,,0,2,0,,,,,1,0,
10/08/13,7,5,2,260,175,85,62,,0,3,0,,,1,,1,0,
10/09/13,18,10,8,229,147,82,60,,0,4,0,,,,,1,0,
10/10/13,14,9,5,248,151,97,61,,0,5,0,,,,,1,0,
10/11/13,7,4,3,251,157,94,57,,0,6,0,,,,,1,0,
10/12/13,6,3,3,269,66,203,60,,1,7,0,,,1,,1,0,
10/13/13,19,4,15,233,51,182,61,,1,1,0,1,,,,1,0,
10/14/13,16,10,6,216,158,58,63,,0,2,0,,,,,1,1,Columbus Day
10/15/13,11,8,3,260,175,85,66,,0,3,0,,,,,1,0,
10/16/13,11,9,2,229,147,82,65,,0,4,0,,,,,1,0,
10/17/13,13,10,3,248,151,97,66,,0,5,0,,,,,,0,
10/18/13,9,8,1,251,157,94,63,,0,6,1,,,,,,0,
10/19/13,20,7,13,269,66,203,64,,1,7,1,,,1,,,0,
10/20/13,9,4,5,233,51,182,61,,1,1,1,,,,,,0,
10/21/13,9,7,2,216,158,58,60,,0,2,1,,,,,,0,
10/22/13,10,8,2,260,175,85,60,,0,3,0,,,,,,0,
10/23/13,14,11,3,229,147,82,59,,0,4,0,,,,,,0,
10/24/13,9,5,4,248,151,97,55,,0,5,0,,,,,,0,
10/25/13,12,7,5,251,157,94,58,,0,6,0,,,,,,0,
10/26/13,19,5,14,269,66,203,61,,1,7,0,,,,,,0,
10/27/13,6,0,6,233,51,182,57,,1,1,0,,,,,,0,
10/28/13,9,9,0,216,158,58,59,,0,2,0,,,,,,0,
10/29/13,11,8,3,260,175,85,56,,0,3,0,,,,,,0,
10/30/13,7,6,1,229,147,82,56,,0,4,0,,,,,,0,
10/31/13,9,8,1,248,151,97,59,,0,5,0,,,,,,1,Halloween
11/01/13,14,8,6,251,157,94,62,,0,6,0,,,,,,0,
11/02/13,8,3,5,269,66,203,57,,1,7,0,,,1,,,0,
11/03/13,14,4,10,233,51,182,56,,1,1,0,,,,,,0,
11/04/13,10,9,1,216,158,58,57,,0,2,0,,,,,,0,
11/05/13,12,10,2,260,175,85,61,,0,3,0,,,1,,,0,
11/06/13,12,11,1,229,147,82,60,,0,4,0,,,,,,0,
11/07/13,17,5,12,248,151,97,61,,0,5,0,,,1,,,0,
11/08/13,8,2,6,251,157,94,59,,0,6,0,,,,,,0,
11/09/13,15,2,13,269,66,203,58,,1,7,0,,,,,,0,
11/10/13,7,3,4,233,51,182,55,,1,1,0,1,,,,,0,
11/11/13,6,6,0,216,158,58,59,,0,2,0,,,,,,1,Veterans Day
11/12/13,6,5,1,260,175,85,62,,0,3,0,,,,,,0,
11/13/13,9,7,2,229,147,82,62,,0,4,0,,,,,,0,
11/14/13,4,3,1,248,151,97,56,,0,5,0,,,,,,0,
11/15/13,16,6,10,251,157,94,56,,0,6,0,,,,,,0,
11/16/13,12,4,8,269,66,203,54,,1,7,0,,,,,,0,
11/17/13,18,7,11,233,51,182,53,,1,1,0,,,,,,0,
11/18/13,4,3,1,216,158,58,52,,0,2,0,,,,,,0,
11/19/13,12,6,6,260,175,85,57,1,0,3,0,,,,,,0,
11/20/13,8,4,4,229,147,82,59,1,0,4,0,,,,,,0,
11/21/13,12,5,7,248,151,97,56,1,0,5,0,,,1,,,0,
11/22/13,8,4,4,251,157,94,59,,0,6,0,,,,,,0,
11/23/13,7,2,5,269,66,203,53,,1,7,0,,,1,,,0,
11/24/13,1,1,0,233,51,182,53,,1,1,0,,,,,,0,
11/25/13,11,8,3,216,158,58,53,,0,2,0,,,,,,0,
11/26/13,11,9,2,260,175,85,53,,0,3,0,,,,,,0,
11/27/13,8,4,4,229,147,82,54,,0,4,0,,,1,,,0,
11/28/13,10,0,10,248,151,97,57,,0,5,0,,,,,,1,Thanksgiving
11/29/13,5,3,2,251,157,94,56,,0,6,0,,,1,,,1,Thanksgiving Friday
11/30/13,8,4,4,269,66,203,55,,1,7,0,,,1,,,0,
12/01/13,6,2,4,233,51,182,54,,1,1,0,1,,,,,0,
12/02/13,12,12,0,216,158,58,53,,0,2,0,,,,,,0,
12/03/13,5,5,0,260,175,85,50,,0,3,0,,,,,,0,
12/04/13,12,10,2,229,147,82,44,,0,4,0,,,,,,0,
12/05/13,11,10,1,248,151,97,40,,0,5,0,,,,,,0,
12/06/13,3,2,1,251,157,94,45,1,0,6,0,,,,,,0,
12/07/13,1,1,0,269,66,203,43,,1,7,0,,,,,,0,
12/08/13,2,1,1,233,51,182,39,,1,1,0,1,,,,,0,
12/09/13,9,9,0,216,158,58,40,,0,2,0,,,,,,0,
12/10/13,7,4,3,260,175,85,41,,0,3,0,,,1,,,0,
12/11/13,7,3,4,229,147,82,44,,0,4,0,,,,,,0,
12/12/13,11,7,4,248,151,97,46,,0,5,0,,,1,,,0,
12/13/13,10,7,3,251,157,94,48,,0,6,0,,,,,,0,
12/14/13,2,2,0,269,66,203,48,,1,7,1,,,,,,0,
12/15/13,4,2,2,233,51,182,48,,1,1,1,,,,,,0,
12/16/13,13,13,0,216,158,58,53,,0,2,1,,,,,,0,
12/17/13,7,7,0,260,175,85,51,,0,3,1,,,,,,0,
12/18/13,5,4,1,229,147,82,51,,0,4,1,,,,,,0,
12/19/13,8,4,4,248,151,97,52,,0,5,0,,,,,,0,
12/20/13,8,4,4,251,157,94,50,,0,6,0,,,,,,0,
12/21/13,8,4,4,269,66,203,49,,1,7,0,,,1,,,0,
12/22/13,8,2,6,233,51,182,53,,1,1,0,,,,,,0,
12/23/13,3,2,1,216,158,58,51,,0,2,0,1,,1,,,0,
12/24/13,4,1,3,260,175,85,56,,0,3,0,,,,,,1,Christmas Eve
12/25/13,4,2,2,229,147,82,52,,0,4,0,,,,,,1,Christmas
12/26/13,6,4,2,248,151,97,53,,0,5,0,,,,,,0,
12/27/13,5,4,1,251,157,94,49,,0,6,0,,,,,,0,
12/28/13,4,0,4,269,66,203,52,,1,7,0,,,,,,0,
12/29/13,6,1,5,233,51,182,55,,1,1,0,,,1,,,0,
12/30/13,7,0,7,216,158,58,50,,0,2,0,,,,,,0,
12/31/13,14,2,12,260,175,85,49,,0,3,0,,,,,,1,New Years Eve
01/01/14,12,0,12,229,147,82,48,,0,4,0,,,,,,1,New Years
01/02/14,6,6,0,248,151,97,53,,0,5,0,,,1,,,0,
01/03/14,7,7,0,251,157,94,52,,0,6,0,,,,,,0,
01/04/14,16,4,12,269,66,203,54,,1,7,0,,,,,,0,
01/05/14,6,0,6,233,51,182,51,,1,1,0,,,,,,0,
01/06/14,6,6,0,216,158,58,51,,0,2,0,,,,,,0,
01/07/14,10,9,1,260,175,85,53,,0,3,0,,,,,,0,
01/08/14,2,2,0,229,147,82,53,1,0,4,0,,,,,,0,
01/09/14,9,7,2,248,151,97,54,1,0,5,0,,,1,,,0,
01/10/14,5,3,2,251,157,94,53,,0,6,0,,,,,,0,
01/11/14,2,0,2,269,66,203,52,,1,7,0,,,1,,,0,
01/12/14,4,1,3,233,51,182,51,,1,1,0,,,,,,0,
01/13/14,10,9,1,216,158,58,57,,0,2,0,,,,,,0,
01/14/14,13,11,2,260,175,85,59,,0,3,0,,,,,,0,
01/15/14,10,8,2,229,147,82,58,,0,4,0,,,,,,0,
01/16/14,10,8,2,248,151,97,57,,0,5,0,,,,,,0,
01/17/14,11,9,2,251,157,94,55,,0,6,0,,,,,,0,
01/18/14,17,5,12,269,66,203,55,,1,7,0,,,,,,0,
01/19/14,10,3,7,233,51,182,53,,1,1,0,,,,,,0,
01/20/14,11,4,7,216,158,58,55,,0,2,0,,,,,,1,MLK Day
01/21/14,12,10,2,260,175,85,54,,0,3,0,,,,,,0,
01/22/14,8,7,1,229,147,82,57,,0,4,0,,,,,,0,
01/23/14,6,4,2,248,151,97,55,,0,5,0,,,1,,,0,
01/24/14,19,11,8,251,157,94,54,,0,6,0,,,,,,0,
01/25/14,5,2,3,269,66,203,59,,1,7,0,,,1,,,0,
01/26/14,6,2,4,233,51,182,58,,1,1,0,,,,,,0,
01/27/14,5,5,0,216,158,58,55,,0,2,0,,,1,,,0,
01/28/14,12,10,2,260,175,85,57,1,0,3,0,,,,,,0,
01/29/14,2,1,1,229,147,82,62,1,0,4,0,,,,,,0,
01/30/14,7,7,0,248,151,97,58,1,0,5,0,,,,,,0,
01/31/14,5,4,1,251,157,94,53,,0,6,0,,,,,,0,
02/01/14,2,1,1,269,66,203,49,,1,7,0,,,1,,,0,
02/02/14,1,0,1,233,51,182,49,1,1,1,0,,,,,,0,
02/03/14,7,6,1,216,158,58,50,,0,2,0,,,1,,,0,
02/04/14,10,9,1,260,175,85,47,,0,3,0,,,,,,0,
02/05/14,3,2,1,229,147,82,47,1,0,4,0,,,1,,,0,
02/06/14,2,2,0,248,151,97,52,1,0,5,0,,,,,,0,
02/07/14,4,3,1,251,157,94,53,1,0,6,0,,,1,,,0,
02/08/14,0,0,0,269,66,203,60,1,1,7,0,,,,,,0,
02/09/14,5,1,4,233,51,182,63,1,1,1,0,,,,,,0,
02/10/14,7,7,0,216,158,58,57,1,0,2,0,,,,,,0,
02/11/14,7,7,0,260,175,85,55,,0,3,0,,,,,,0,
02/12/14,9,5,4,229,147,82,55,,0,4,0,,,,,,0,
02/13/14,9,4,5,248,151,97,60,,0,5,0,,,,,,0,
02/14/14,10,5,5,251,157,94,59,,0,6,0,,,,,,1,Valentine's Day
02/15/14,8,1,7,269,66,203,57,1,1,7,0,,,,,,0,
02/16/14,12,0,12,233,51,182,57,1,1,1,0,,,,,,0,
02/17/14,1,1,0,216,158,58,52,,0,2,0,,,,,,1,Presidents' Day
02/18/14,6,5,1,260,175,85,54,,0,3,0,,,,,,0,
02/19/14,5,3,2,229,147,82,58,1,0,4,0,,,,,,0,
02/20/14,3,3,0,248,151,97,57,,0,5,0,,,,,,0,
02/21/14,12,11,1,251,157,94,58,,0,6,0,,,,,,0,
02/22/14,8,2,6,269,66,203,58,,1,7,0,,,,,,0,
02/23/14,3,1,2,233,51,182,59,,1,1,0,,,,,,0,
02/24/14,10,10,0,216,158,58,60,,0,2,0,,,,,,0,
02/25/14,12,11,1,260,175,85,56,,0,3,0,,,,,,0,
02/26/14,6,6,0,229,147,82,58,1,0,4,0,,,,,,0,
02/27/14,5,5,0,248,151,97,60,1,0,5,0,,,,,,0,
02/28/14,7,7,0,251,157,94,59,1,0,6,0,,,,,,0,
