date,total,subscriber,customer,totalAvg,subscriberAvg,customerAvg,temp,rain,weekend,weekday,BART,49ers,Giants,Sharks,AmericasCup,USGovShutdown,holiday,holidayName
08/29/13,9,6,3,122,102,20,71,,0,5,0,,,,,,0,
08/30/13,9,8,1,157,124,33,74,,0,6,0,,,,,,0,
08/31/13,5,5,0,74,42,32,68,,1,7,0,,,,,,0,
09/01/13,6,3,3,46,16,30,71,,1,1,0,,,,,,0,
09/02/13,4,1,3,118,108,10,70,,0,2,0,,,,,,1,Labor Day
09/03/13,10,4,6,157,134,23,68,,0,3,0,,,,,,0,
09/04/13,2,1,1,119,105,14,68,,0,4,0,,,,,,0,
09/05/13,8,6,2,122,102,20,68,,0,5,0,,1,,,,0,
09/06/13,12,10,2,157,124,33,73,,0,6,0,,1,,,,0,
09/07/13,4,2,2,74,42,32,78,,1,7,0,,1,,1,,0,
09/08/13,2,2,0,46,16,30,68,,1,1,0,1,1,,1,,0,
09/09/13,1,1,0,118,108,10,73,,0,2,0,,1,,,,0,
09/10/13,8,8,0,157,134,23,70,,0,3,0,,1,,1,,0,
09/11/13,6,6,0,119,105,14,67,,0,4,0,,1,,,,0,
09/12/13,7,7,0,122,102,20,68,,0,5,0,,,,1,,0,
09/13/13,8,7,1,157,124,33,67,,0,6,0,,,,,,0,
09/14/13,9,8,1,74,42,32,62,,1,7,0,,,,1,,0,
09/15/13,1,1,0,46,16,30,68,,1,1,0,,,,1,,0,
09/16/13,15,14,1,118,108,10,68,,0,2,0,,,,,,0,
09/17/13,6,5,1,157,134,23,64,,0,3,0,,,,1,,0,
09/18/13,8,7,1,119,105,14,68,,0,4,0,,,,1,,0,
09/19/13,8,6,2,122,102,20,70,,0,5,0,,,,1,,0,
09/20/13,7,7,0,157,124,33,67,,0,6,0,,,,1,,0,
09/21/13,1,1,0,74,42,32,62,1,1,7,0,,,,1,,0,
09/22/13,1,0,1,46,16,30,63,,1,1,0,1,,,1,,0,
09/23/13,9,9,0,118,108,10,68,,0,2,0,,,,1,,0,
09/24/13,11,8,3,157,134,23,65,,0,3,0,,1,,1,,0,
09/25/13,6,5,1,119,105,14,60,,0,4,0,,1,,1,,0,
09/26/13,7,7,0,122,102,20,64,,0,5,0,,1,,,,0,
09/27/13,10,8,2,157,124,33,64,,0,6,0,,1,,,,0,
09/28/13,6,6,0,74,42,32,66,,1,7,0,,1,,,,0,
09/29/13,2,2,0,46,16,30,65,,1,1,0,,1,,,,0,
09/30/13,5,5,0,118,108,10,66,,0,2,0,,,,,,0,
10/01/13,13,13,0,157,134,23,64,,0,3,0,,,,,1,0,
10/02/13,9,9,0,119,105,14,63,,0,4,0,,,,,1,0,
10/03/13,8,7,1,122,102,20,63,,0,5,0,,,1,,1,0,
10/04/13,9,9,0,157,124,33,68,,0,6,0,,,,,1,0,
10/05/13,5,1,4,74,42,32,68,,1,7,0,,,1,,1,0,
10/06/13,3,0,3,46,16,30,68,,1,1,0,1,,,,1,0,
10/07/13,9,8,1,118,108,10,68,,0,2,0,,,,,1,0,
10/08/13,7,7,0,157,134,23,62,,0,3,0,,,1,,1,0,
10/09/13,8,8,0,119,105,14,59,,0,4,0,,,,,1,0,
10/10/13,2,2,0,122,102,20,59,,0,5,0,,,,,1,0,
10/11/13,9,9,0,157,124,33,58,,0,6,0,,,,,1,0,
10/12/13,1,1,0,74,42,32,56,,1,7,0,,,1,,1,0,
10/13/13,8,1,7,46,16,30,62,,1,1,0,1,,,,1,0,
10/14/13,3,3,0,118,108,10,64,,0,2,0,,,,,1,1,Columbus Day
10/15/13,9,6,3,157,134,23,64,,0,3,0,,,,,1,0,
10/16/13,3,3,0,119,105,14,66,,0,4,0,,,,,1,0,
10/17/13,11,10,1,122,102,20,66,,0,5,0,,,,,,0,
10/18/13,5,4,1,157,124,33,60,,0,6,1,,,,,,0,
10/19/13,2,2,0,74,42,32,64,,1,7,1,,,1,,,0,
10/20/13,4,3,1,46,16,30,58,,1,1,1,,,,,,0,
10/21/13,9,8,1,118,108,10,55,,0,2,1,,,,,,0,
10/22/13,10,10,0,157,134,23,57,,0,3,0,,,,,,0,
10/23/13,8,7,1,119,105,14,56,,0,4,0,,,,,,0,
10/24/13,6,6,0,122,102,20,54,,0,5,0,,,,,,0,
10/25/13,2,2,0,157,124,33,57,,0,6,0,,,,,,0,
10/26/13,1,1,0,74,42,32,60,,1,7,0,,,,,,0,
10/27/13,2,1,1,46,16,30,52,,1,1,0,,,,,,0,
10/28/13,8,8,0,118,108,10,56,,0,2,0,,,,,,0,
10/29/13,8,8,0,157,134,23,55,1,0,3,0,,,,,,0,
10/30/13,6,6,0,119,105,14,55,,0,4,0,,,,,,0,
10/31/13,4,4,0,122,102,20,58,,0,5,0,,,,,,1,Halloween
11/01/13,7,5,2,157,124,33,60,,0,6,0,,,,,,0,
11/02/13,5,0,5,74,42,32,58,,1,7,0,,,1,,,0,
11/03/13,3,0,3,46,16,30,54,,1,1,0,,,,,,0,
11/04/13,4,4,0,118,108,10,55,,0,2,0,,,,,,0,
11/05/13,12,11,1,157,134,23,58,,0,3,0,,,1,,,0,
11/06/13,8,6,2,119,105,14,58,,0,4,0,,,,,,0,
11/07/13,7,3,4,122,102,20,60,,0,5,0,,,1,,,0,
11/08/13,22,8,14,157,124,33,60,,0,6,0,,,,,,0,
11/09/13,10,5,5,74,42,32,57,,1,7,0,,,,,,0,
11/10/13,9,2,7,46,16,30,54,,1,1,0,1,,,,,0,
11/11/13,4,3,1,118,108,10,56,,0,2,0,,,,,,1,Veterans Day
11/12/13,8,8,0,157,134,23,62,,0,3,0,,,,,,0,
11/13/13,7,5,2,119,105,14,62,,0,4,0,,,,,,0,
11/14/13,9,9,0,122,102,20,56,,0,5,0,,,,,,0,
11/15/13,10,10,0,157,124,33,55,,0,6,0,,,,,,0,
11/16/13,2,2,0,74,42,32,56,,1,7,0,,,,,,0,
11/17/13,0,0,0,46,16,30,52,,1,1,0,,,,,,0,
11/18/13,10,10,0,118,108,10,52,,0,2,0,,,,,,0,
11/19/13,5,5,0,157,134,23,54,1,0,3,0,,,,,,0,
11/20/13,6,6,0,119,105,14,55,1,0,4,0,,,,,,0,
11/21/13,4,4,0,122,102,20,56,1,0,5,0,,,1,,,0,
11/22/13,5,5,0,157,124,33,57,,0,6,0,,,,,,0,
11/23/13,1,1,0,74,42,32,54,,1,7,0,,,1,,,0,
11/24/13,0,0,0,46,16,30,53,,1,1,0,,,,,,0,
11/25/13,7,7,0,118,108,10,50,,0,2,0,,,,,,0,
11/26/13,7,7,0,157,134,23,53,,0,3,0,,,,,,0,
11/27/13,4,4,0,119,105,14,54,,0,4,0,,,1,,,0,
11/28/13,2,0,2,122,102,20,57,,0,5,0,,,,,,1,Thanksgiving
11/29/13,1,0,1,157,124,33,54,,0,6,0,,,1,,,1,Thanksgiving Friday
11/30/13,0,0,0,74,42,32,52,,1,7,0,,,1,,,0,
12/01/13,0,0,0,46,16,30,56,,1,1,0,1,,,,,0,
12/02/13,2,2,0,118,108,10,54,,0,2,0,,,,,,0,
12/03/13,3,3,0,157,134,23,50,,0,3,0,,,,,,0,
12/04/13,3,3,0,119,105,14,42,,0,4,0,,,,,,0,
12/05/13,4,4,0,122,102,20,41,,0,5,0,,,,,,0,
12/06/13,2,2,0,157,124,33,42,1,0,6,0,,,,,,0,
12/07/13,1,1,0,74,42,32,44,1,1,7,0,,,,,,0,
12/08/13,0,0,0,46,16,30,38,,1,1,0,1,,,,,0,
12/09/13,0,0,0,118,108,10,41,,0,2,0,,,,,,0,
12/10/13,1,1,0,157,134,23,42,,0,3,0,,,1,,,0,
12/11/13,2,2,0,119,105,14,44,,0,4,0,,,,,,0,
12/12/13,4,4,0,122,102,20,44,,0,5,0,,,1,,,0,
12/13/13,3,3,0,157,124,33,45,,0,6,0,,,,,,0,
12/14/13,1,1,0,74,42,32,48,,1,7,1,,,,,,0,
12/15/13,0,0,0,46,16,30,47,,1,1,1,,,,,,0,
12/16/13,4,4,0,118,108,10,50,,0,2,1,,,,,,0,
12/17/13,5,3,2,157,134,23,50,,0,3,1,,,,,,0,
12/18/13,4,4,0,119,105,14,48,,0,4,1,,,,,,0,
12/19/13,1,1,0,122,102,20,50,,0,5,0,,,,,,0,
12/20/13,1,1,0,157,124,33,46,,0,6,0,,,,,,0,
12/21/13,2,0,2,74,42,32,50,,1,7,0,,,1,,,0,
12/22/13,0,0,0,46,16,30,52,,1,1,0,,,,,,0,
12/23/13,2,2,0,118,108,10,50,,0,2,0,1,,1,,,0,
12/24/13,4,1,3,157,134,23,54,,0,3,0,,,,,,1,Christmas Eve
12/25/13,0,0,0,119,105,14,52,,0,4,0,,,,,,1,Christmas
12/26/13,5,2,3,122,102,20,52,,0,5,0,,,,,,0,
12/27/13,3,3,0,157,124,33,48,,0,6,0,,,,,,0,
12/28/13,0,0,0,74,42,32,50,,1,7,0,,,,,,0,
12/29/13,0,0,0,46,16,30,52,,1,1,0,,,1,,,0,
12/30/13,1,1,0,118,108,10,48,,0,2,0,,,,,,0,
12/31/13,1,1,0,157,134,23,48,,0,3,0,,,,,,1,New Years Eve
01/01/14,0,0,0,119,105,14,47,,0,4,0,,,,,,1,New Years
01/02/14,3,2,1,122,102,20,50,,0,5,0,,,1,,,0,
01/03/14,4,4,0,157,124,33,48,,0,6,0,,,,,,0,
01/04/14,4,2,2,74,42,32,52,,1,7,0,,,,,,0,
01/05/14,0,0,0,46,16,30,50,,1,1,0,,,,,,0,
01/06/14,1,1,0,118,108,10,49,,0,2,0,,,,,,0,
01/07/14,3,3,0,157,134,23,52,,0,3,0,,,,,,0,
01/08/14,4,3,1,119,105,14,52,,0,4,0,,,,,,0,
01/09/14,1,1,0,122,102,20,52,,0,5,0,,,1,,,0,
01/10/14,3,3,0,157,124,33,52,,0,6,0,,,,,,0,
01/11/14,0,0,0,74,42,32,50,,1,7,0,,,1,,,0,
01/12/14,3,1,2,46,16,30,50,,1,1,0,,,,,,0,
01/13/14,4,2,2,118,108,10,54,,0,2,0,,,,,,0,
01/14/14,2,2,0,157,134,23,55,,0,3,0,,,,,,0,
01/15/14,4,4,0,119,105,14,56,,0,4,0,,,,,,0,
01/16/14,4,4,0,122,102,20,56,,0,5,0,,,,,,0,
01/17/14,8,8,0,157,124,33,52,,0,6,0,,,,,,0,
01/18/14,1,1,0,74,42,32,52,,1,7,0,,,,,,0,
01/19/14,1,0,1,46,16,30,52,,1,1,0,,,,,,0,
01/20/14,3,3,0,118,108,10,52,,0,2,0,,,,,,1,MLK Day
01/21/14,4,4,0,157,134,23,54,,0,3,0,,,,,,0,
01/22/14,5,2,3,119,105,14,52,,0,4,0,,,,,,0,
01/23/14,2,2,0,122,102,20,54,,0,5,0,,,1,,,0,
01/24/14,3,3,0,157,124,33,50,,0,6,0,,,,,,0,
01/25/14,0,0,0,74,42,32,56,,1,7,0,,,1,,,0,
01/26/14,0,0,0,46,16,30,58,,1,1,0,,,,,,0,
01/27/14,3,3,0,118,108,10,52,,0,2,0,,,1,,,0,
01/28/14,3,3,0,157,134,23,58,,0,3,0,,,,,,0,
01/29/14,3,3,0,119,105,14,60,,0,4,0,,,,,,0,
01/30/14,1,1,0,122,102,20,55,1,0,5,0,,,,,,0,
01/31/14,2,1,1,157,124,33,52,,0,6,0,,,,,,0,
02/01/14,2,0,2,74,42,32,48,,1,7,0,,,1,,,0,
02/02/14,0,0,0,46,16,30,47,1,1,1,0,,,,,,0,
02/03/14,3,3,0,118,108,10,47,,0,2,0,,,1,,,0,
02/04/14,6,4,2,157,134,23,46,,0,3,0,,,,,,0,
02/05/14,4,4,0,119,105,14,47,1,0,4,0,,,1,,,0,
02/06/14,0,0,0,122,102,20,50,1,0,5,0,,,,,,0,
02/07/14,0,0,0,157,124,33,54,1,0,6,0,,,1,,,0,
02/08/14,0,0,0,74,42,32,56,1,1,7,0,,,,,,0,
02/09/14,0,0,0,46,16,30,58,1,1,1,0,,,,,,0,
02/10/14,3,3,0,118,108,10,54,,0,2,0,,,,,,0,
02/11/14,6,4,2,157,134,23,52,,0,3,0,,,,,,0,
02/12/14,4,2,2,119,105,14,52,,0,4,0,,,,,,0,
02/13/14,1,0,1,122,102,20,59,,0,5,0,,,,,,0,
02/14/14,1,1,0,157,124,33,56,,0,6,0,,,,,,1,Valentine's Day
02/15/14,2,2,0,74,42,32,54,1,1,7,0,,,,,,0,
02/16/14,0,0,0,46,16,30,55,1,1,1,0,,,,,,0,
02/17/14,0,0,0,118,108,10,50,,0,2,0,,,,,,1,Presidents' Day
02/18/14,1,1,0,157,134,23,54,,0,3,0,,,,,,0,
02/19/14,5,5,0,119,105,14,56,,0,4,0,,,,,,0,
02/20/14,1,1,0,122,102,20,56,,0,5,0,,,,,,0,
02/21/14,10,2,8,157,124,33,58,,0,6,0,,,,,,0,
02/22/14,9,0,9,74,42,32,56,,1,7,0,,,,,,0,
02/23/14,1,0,1,46,16,30,56,,1,1,0,,,,,,0,
02/24/14,4,3,1,118,108,10,58,,0,2,0,,,,,,0,
02/25/14,4,4,0,157,134,23,55,,0,3,0,,,,,,0,
02/26/14,0,0,0,119,105,14,56,1,0,4,0,,,,,,0,
02/27/14,3,3,0,122,102,20,60,1,0,5,0,,,,,,0,
02/28/14,1,1,0,157,124,33,58,1,0,6,0,,,,,,0,
