date,total,subscriber,customer,totalAvg,subscriberAvg,customerAvg,temp,rain,weekend,weekday,BART,49ers,Giants,Sharks,AmericasCup,USGovShutdown,holiday,holidayName
08/29/13,642,383,259,22818,19323,3495,68,,0,5,0,,,,,,0,
08/30/13,606,253,353,21918,17899,4019,69,,0,6,0,,,,,,0,
08/31/13,556,127,429,11037,5398,5639,64,,1,7,0,,,,,,0,
09/01/13,600,102,498,9328,4453,4875,66,,1,1,0,,,,,,0,
09/02/13,594,144,450,20978,17881,3097,69,,0,2,0,,,,,,1,Labor Day
09/03/13,523,271,252,22376,19481,2895,67,,0,3,0,,,,,,0,
09/04/13,515,308,207,21398,18300,3098,68,,0,4,0,,,,,,0,
09/05/13,602,348,254,22818,19323,3495,66,,0,5,0,,1,,,,0,
09/06/13,719,400,319,21918,17899,4019,71,,0,6,0,,1,,,,0,
09/07/13,716,216,500,11037,5398,5639,73,,1,7,0,,1,,1,,0,
09/08/13,626,164,462,9328,4453,4875,65,,1,1,0,1,1,,1,,0,
09/09/13,692,456,236,20978,17881,3097,66,,0,2,0,,1,,,,0,
09/10/13,797,561,236,22376,19481,2895,66,,0,3,0,,1,,1,,0,
09/11/13,799,555,244,21398,18300,3098,68,,0,4,0,,1,,,,0,
09/12/13,855,606,249,22818,19323,3495,65,,0,5,0,,,,1,,0,
09/13/13,886,600,286,21918,17899,4019,62,,0,6,0,,,,,,0,
09/14/13,610,227,383,11037,5398,5639,62,,1,7,0,,,,1,,0,
09/15/13,575,223,352,9328,4453,4875,66,,1,1,0,,,,1,,0,
09/16/13,833,610,223,20978,17881,3097,65,,0,2,0,,,,,,0,
09/17/13,990,716,274,22376,19481,2895,63,,0,3,0,,,,1,,0,
09/18/13,1015,768,247,21398,18300,3098,66,,0,4,0,,,,1,,0,
09/19/13,956,721,235,22818,19323,3495,67,,0,5,0,,,,1,,0,
09/20/13,971,697,274,21918,17899,4019,65,,0,6,0,,,,1,,0,
09/21/13,317,180,137,11037,5398,5639,63,1,1,7,0,,,,1,,0,
09/22/13,531,209,322,9328,4453,4875,63,,1,1,0,1,,,1,,0,
09/23/13,943,729,214,20978,17881,3097,68,,0,2,0,,,,1,,0,
09/24/13,977,757,220,22376,19481,2895,65,,0,3,0,,1,,1,,0,
09/25/13,1154,798,356,21398,18300,3098,62,,0,4,0,,1,,1,,0,
09/26/13,976,758,218,22818,19323,3495,62,,0,5,0,,1,,,,0,
09/27/13,1009,764,245,21918,17899,4019,66,,0,6,0,,1,,,,0,
09/28/13,553,225,328,11037,5398,5639,66,,1,7,0,,1,,,,0,
09/29/13,479,224,255,9328,4453,4875,66,,1,1,0,,1,,,,0,
09/30/13,891,777,114,20978,17881,3097,66,,0,2,0,,,,,,0,
10/01/13,969,819,150,22376,19481,2895,63,,0,3,0,,,,,1,0,
10/02/13,955,787,168,21398,18300,3098,62,,0,4,0,,,,,1,0,
10/03/13,1036,793,243,22818,19323,3495,62,,0,5,0,,,1,,1,0,
10/04/13,973,745,228,21918,17899,4019,69,,0,6,0,,,,,1,0,
10/05/13,626,262,364,11037,5398,5639,69,,1,7,0,,,1,,1,0,
10/06/13,514,210,304,9328,4453,4875,70,,1,1,0,1,,,,1,0,
10/07/13,884,752,132,20978,17881,3097,68,,0,2,0,,,,,1,0,
10/08/13,909,790,119,22376,19481,2895,62,,0,3,0,,,1,,1,0,
10/09/13,966,830,136,21398,18300,3098,60,,0,4,0,,,,,1,0,
10/10/13,988,807,181,22818,19323,3495,62,,0,5,0,,,,,1,0,
10/11/13,907,745,162,21918,17899,4019,57,,0,6,0,,,,,1,0,
10/12/13,608,280,328,11037,5398,5639,56,,1,7,0,,,1,,1,0,
10/13/13,505,235,270,9328,4453,4875,62,,1,1,0,1,,,,1,0,
10/14/13,954,751,203,20978,17881,3097,64,,0,2,0,,,,,1,1,Columbus Day
10/15/13,1069,855,214,22376,19481,2895,67,,0,3,0,,,,,1,0,
10/16/13,1075,901,174,21398,18300,3098,67,,0,4,0,,,,,1,0,
10/17/13,1106,899,207,22818,19323,3495,68,,0,5,0,,,,,,0,
10/18/13,999,771,228,21918,17899,4019,60,,0,6,1,,,,,,0,
10/19/13,564,242,322,11037,5398,5639,62,,1,7,1,,,1,,,0,
10/20/13,389,181,208,9328,4453,4875,57,,1,1,1,,,,,,0,
10/21/13,910,773,137,20978,17881,3097,55,,0,2,1,,,,,,0,
10/22/13,910,820,90,22376,19481,2895,56,,0,3,0,,,,,,0,
10/23/13,907,840,67,21398,18300,3098,55,,0,4,0,,,,,,0,
10/24/13,918,825,93,22818,19323,3495,57,,0,5,0,,,,,,0,
10/25/13,953,845,108,21918,17899,4019,59,,0,6,0,,,,,,0,
10/26/13,448,252,196,11037,5398,5639,60,,1,7,0,,,,,,0,
10/27/13,251,170,81,9328,4453,4875,55,1,1,1,0,,,,,,0,
10/28/13,865,804,61,20978,17881,3097,57,,0,2,0,,,,,,0,
10/29/13,922,844,78,22376,19481,2895,58,,0,3,0,,,,,,0,
10/30/13,1017,922,95,21398,18300,3098,57,,0,4,0,,,,,,0,
10/31/13,1055,909,146,22818,19323,3495,59,,0,5,0,,,,,,1,Halloween
11/01/13,1032,880,152,21918,17899,4019,63,,0,6,0,,,,,,0,
11/02/13,507,242,265,11037,5398,5639,57,,1,7,0,,,1,,,0,
11/03/13,327,190,137,9328,4453,4875,55,,1,1,0,,,,,,0,
11/04/13,1042,933,109,20978,17881,3097,56,,0,2,0,,,,,,0,
11/05/13,1052,915,137,22376,19481,2895,61,,0,3,0,,,1,,,0,
11/06/13,986,865,121,21398,18300,3098,61,,0,4,0,,,,,,0,
11/07/13,1077,943,134,22818,19323,3495,64,,0,5,0,,,1,,,0,
11/08/13,1073,895,178,21918,17899,4019,60,,0,6,0,,,,,,0,
11/09/13,573,288,285,11037,5398,5639,57,,1,7,0,,,,,,0,
11/10/13,434,200,234,9328,4453,4875,58,,1,1,0,1,,,,,0,
11/11/13,908,786,122,20978,17881,3097,58,,0,2,0,,,,,,1,Veterans Day
11/12/13,1068,959,109,22376,19481,2895,64,,0,3,0,,,,,,0,
11/13/13,910,853,57,21398,18300,3098,60,,0,4,0,,,,,,0,
11/14/13,1013,945,68,22818,19323,3495,56,,0,5,0,,,,,,0,
11/15/13,1030,882,148,21918,17899,4019,58,,0,6,0,,,,,,0,
11/16/13,430,259,171,11037,5398,5639,56,,1,7,0,,,,,,0,
11/17/13,361,209,152,9328,4453,4875,56,,1,1,0,,,,,,0,
11/18/13,937,863,74,20978,17881,3097,53,,0,2,0,,,,,,0,
11/19/13,676,627,49,22376,19481,2895,58,1,0,3,0,,,,,,0,
11/20/13,552,524,28,21398,18300,3098,55,1,0,4,0,,,,,,0,
11/21/13,998,909,89,22818,19323,3495,56,1,0,5,0,,,1,,,0,
11/22/13,912,819,93,21918,17899,4019,63,,0,6,0,,,,,,0,
11/23/13,458,212,246,11037,5398,5639,58,,1,7,0,,,1,,,0,
11/24/13,304,172,132,9328,4453,4875,53,,1,1,0,,,,,,0,
11/25/13,923,835,88,20978,17881,3097,53,,0,2,0,,,,,,0,
11/26/13,893,809,84,22376,19481,2895,55,,0,3,0,,,,,,0,
11/27/13,637,581,56,21398,18300,3098,55,,0,4,0,,,1,,,0,
11/28/13,243,99,144,22818,19323,3495,58,,0,5,0,,,,,,1,Thanksgiving
11/29/13,345,171,174,21918,17899,4019,54,,0,6,0,,,1,,,1,Thanksgiving Friday
11/30/13,272,143,129,11037,5398,5639,54,,1,7,0,,,1,,,0,
12/01/13,291,191,100,9328,4453,4875,57,,1,1,0,1,,,,,0,
12/02/13,793,772,21,20978,17881,3097,54,,0,2,0,,,,,,0,
12/03/13,835,809,26,22376,19481,2895,51,,0,3,0,,,,,,0,
12/04/13,889,844,45,21398,18300,3098,46,,0,4,0,,,,,,0,
12/05/13,846,782,64,22818,19323,3495,43,,0,5,0,,,,,,0,
12/06/13,665,602,63,21918,17899,4019,45,1,0,6,0,,,,,,0,
12/07/13,259,176,83,11037,5398,5639,45,1,1,7,0,,,,,,0,
12/08/13,247,180,67,9328,4453,4875,42,,1,1,0,1,,,,,0,
12/09/13,716,690,26,20978,17881,3097,44,,0,2,0,,,,,,0,
12/10/13,806,752,54,22376,19481,2895,43,,0,3,0,,,1,,,0,
12/11/13,812,750,62,21398,18300,3098,48,,0,4,0,,,,,,0,
12/12/13,882,804,78,22818,19323,3495,46,,0,5,0,,,1,,,0,
12/13/13,887,766,121,21918,17899,4019,47,,0,6,0,,,,,,0,
12/14/13,364,243,121,11037,5398,5639,50,,1,7,1,,,,,,0,
12/15/13,289,180,109,9328,4453,4875,50,,1,1,1,,,,,,0,
12/16/13,863,766,97,20978,17881,3097,54,,0,2,1,,,,,,0,
12/17/13,904,834,70,22376,19481,2895,53,,0,3,1,,,,,,0,
12/18/13,854,799,55,21398,18300,3098,51,,0,4,1,,,,,,0,
12/19/13,865,773,92,22818,19323,3495,53,,0,5,0,,,,,,0,
12/20/13,786,706,80,21918,17899,4019,50,,0,6,0,,,,,,0,
12/21/13,313,215,98,11037,5398,5639,54,,1,7,0,,,1,,,0,
12/22/13,275,153,122,9328,4453,4875,54,,1,1,0,,,,,,0,
12/23/13,578,485,93,20978,17881,3097,52,,0,2,0,1,,1,,,0,
12/24/13,316,226,90,22376,19481,2895,52,,0,3,0,,,,,,1,Christmas Eve
12/25/13,334,78,256,21398,18300,3098,53,,0,4,0,,,,,,1,Christmas
12/26/13,376,290,86,22818,19323,3495,53,,0,5,0,,,,,,0,
12/27/13,395,294,101,21918,17899,4019,50,,0,6,0,,,,,,0,
12/28/13,373,167,206,11037,5398,5639,52,,1,7,0,,,,,,0,
12/29/13,294,128,166,9328,4453,4875,55,,1,1,0,,,1,,,0,
12/30/13,558,442,116,20978,17881,3097,51,,0,2,0,,,,,,0,
12/31/13,472,331,141,22376,19481,2895,50,,0,3,0,,,,,,1,New Years Eve
01/01/14,334,115,219,21398,18300,3098,49,,0,4,0,,,,,,1,New Years
01/02/14,702,579,123,22818,19323,3495,53,,0,5,0,,,1,,,0,
01/03/14,700,588,112,21918,17899,4019,54,,0,6,0,,,,,,0,
01/04/14,318,208,110,11037,5398,5639,55,,1,7,0,,,,,,0,
01/05/14,236,174,62,9328,4453,4875,55,,1,1,0,,,,,,0,
01/06/14,843,777,66,20978,17881,3097,52,,0,2,0,,,,,,0,
01/07/14,855,807,48,22376,19481,2895,54,1,0,3,0,,,,,,0,
01/08/14,892,818,74,21398,18300,3098,56,,0,4,0,,,,,,0,
01/09/14,888,788,100,22818,19323,3495,56,,0,5,0,,,1,,,0,
01/10/14,892,792,100,21918,17899,4019,54,,0,6,0,,,,,,0,
01/11/14,216,146,70,11037,5398,5639,52,,1,7,0,,,1,,,0,
01/12/14,305,152,153,9328,4453,4875,53,,1,1,0,,,,,,0,
01/13/14,917,853,64,20978,17881,3097,55,,0,2,0,,,,,,0,
01/14/14,928,856,72,22376,19481,2895,58,,0,3,0,,,,,,0,
01/15/14,1001,908,93,21398,18300,3098,61,,0,4,0,,,,,,0,
01/16/14,983,905,78,22818,19323,3495,60,,0,5,0,,,,,,0,
01/17/14,906,791,115,21918,17899,4019,56,,0,6,0,,,,,,0,
01/18/14,388,199,189,11037,5398,5639,55,,1,7,0,,,,,,0,
01/19/14,325,144,181,9328,4453,4875,55,,1,1,0,,,,,,0,
01/20/14,541,415,126,20978,17881,3097,55,,0,2,0,,,,,,1,MLK Day
01/21/14,911,862,49,22376,19481,2895,56,,0,3,0,,,,,,0,
01/22/14,962,892,70,21398,18300,3098,55,,0,4,0,,,,,,0,
01/23/14,974,869,105,22818,19323,3495,57,,0,5,0,,,1,,,0,
01/24/14,912,844,68,21918,17899,4019,55,,0,6,0,,,,,,0,
01/25/14,404,233,171,11037,5398,5639,57,,1,7,0,,,1,,,0,
01/26/14,357,209,148,9328,4453,4875,57,,1,1,0,,,,,,0,
01/27/14,877,873,4,20978,17881,3097,54,,0,2,0,,,1,,,0,
01/28/14,938,884,54,22376,19481,2895,59,,0,3,0,,,,,,0,
01/29/14,865,826,39,21398,18300,3098,59,1,0,4,0,,,,,,0,
01/30/14,872,838,34,22818,19323,3495,55,1,0,5,0,,,,,,0,
01/31/14,757,699,58,21918,17899,4019,54,,0,6,0,,,,,,0,
02/01/14,318,193,125,11037,5398,5639,51,,1,7,0,,,1,,,0,
02/02/14,99,54,45,9328,4453,4875,53,1,1,1,0,,,,,,0,
02/03/14,867,797,70,20978,17881,3097,51,,0,2,0,,,1,,,0,
02/04/14,886,833,53,22376,19481,2895,50,,0,3,0,,,,,,0,
02/05/14,784,744,40,21398,18300,3098,49,1,0,4,0,,,1,,,0,
02/06/14,439,408,31,22818,19323,3495,50,1,0,5,0,,,,,,0,
02/07/14,405,385,20,21918,17899,4019,54,1,0,6,0,,,1,,,0,
02/08/14,66,55,11,11037,5398,5639,56,1,1,7,0,,,,,,0,
02/09/14,59,52,7,9328,4453,4875,57,1,1,1,0,,,,,,0,
02/10/14,718,662,56,20978,17881,3097,54,1,0,2,0,,,,,,0,
02/11/14,854,817,37,22376,19481,2895,53,,0,3,0,,,,,,0,
02/12/14,913,835,78,21398,18300,3098,51,,0,4,0,,,,,,0,
02/13/14,846,783,63,22818,19323,3495,59,,0,5,0,,,,,,0,
02/14/14,879,772,107,21918,17899,4019,61,,0,6,0,,,,,,1,Valentine's Day
02/15/14,385,205,180,11037,5398,5639,57,1,1,7,0,,,,,,0,
02/16/14,390,209,181,9328,4453,4875,57,,1,1,0,,,,,,0,
02/17/14,429,275,154,20978,17881,3097,54,,0,2,0,,,,,,1,Presidents' Day
02/18/14,921,814,107,22376,19481,2895,55,,0,3,0,,,,,,0,
02/19/14,918,828,90,21398,18300,3098,57,,0,4,0,,,,,,0,
02/20/14,893,830,63,22818,19323,3495,56,,0,5,0,,,,,,0,
02/21/14,831,746,85,21918,17899,4019,58,,0,6,0,,,,,,0,
02/22/14,395,203,192,11037,5398,5639,56,,1,7,0,,,,,,0,
02/23/14,265,138,127,9328,4453,4875,55,,1,1,0,,,,,,0,
02/24/14,902,861,41,20978,17881,3097,58,,0,2,0,,,,,,0,
02/25/14,995,913,82,22376,19481,2895,55,,0,3,0,,,,,,0,
02/26/14,352,331,21,21398,18300,3098,57,1,0,4,0,,,,,,0,
02/27/14,787,729,58,22818,19323,3495,58,1,0,5,0,,,,,,0,
02/28/14,488,447,41,21918,17899,4019,59,1,0,6,0,,,,,,0,
